********************
*Y  **     L*      *
*** ** ***    ** * *
*G*     ** ****  *W*
* * ** *** **   **G*
*   **  M**** ******
******* ***** ** DQ*
*B*      B**     ***
* W  ***TBG*****  **
**** *********G** **
****     B  ** ** **
*  WW****** **  B  *
*D****       ***** *
*E*P   ***N        *
********************