************
**  *    *****
** + @!*  ***
********
************