1                      111111111111111111111111111111111111111111111111111111111111111111111111111111111111111111111111111111111111111111
11                    1111111111111111111111111111111111111111111111111111111111111111111111111111111111111111111111111111111111111111111
111                  11111111111111111111111111111111111111111111111111111111111111111111111111111111111111111111111111111111111111111111
1111                111111111111111111111111111111111111111111111111111111111111111111111111111111111111111111111111111111111111111111111
11111              1111111111111111111111111111111111111111111111111111111111111111111111111111111111111111111111111111111111111111111111
111111       M     111111111111111111111111111111111111111111111111111111111111111111111111111111111111111111111111111111111111111111111
1111111          11111111111111111111111111111111111111111111111111111111111111111111111111111111111111111111111111111111111111111111
11111111        1111111111111111111111111111111111111111111111111111111111111111111111111111111111111111111111111111111111111111111
111111111      111111111111111111111111111111111111111111111111111111111111111111111111111111111111111111111111111111111111111111
1111111111    111111111111111111111111111111111111111111111111111111111111111111111111111111111111111111111111111111111111111111
1111111111   111111111111111111111111111111111111111111111111111111111111111111111111111111111111111111111111111111111111111111
1111111111$    111111111111111111111111111111111111111111111111111111111111111111111111111111111111111111111111111111111111111111
111111111      111111111111111111111111111111111111111111111111111111111111111111111111111111111111111111111111111111111111111111
11111111        111111111111111111111111111111111111111111111111111111111111111111111111111111111111111111111111111111111111111111
111111111        111111111111111111111111111111111111111111111111111111111111111111111111111111111111111111111111111111111111111111
1111111111                     111111111111111111111111111111111111111111111111111111111111111111111111111111111111111111111111111111111111111111
11111111111    W     !         $       111111111111111111111111111111111111111111111111111111111111111111111111111111111111111111111111111111111111111111
11111111111                         111111111111111111111111111111111111111111111111111111111              1111111111111111111111111111111111111
11111111            1111111111111     1111111111111111111111111111111111111111111111111111111                 111111111111111111111111111
111111111            111111111111       1111111111111111111111111111111111111111111111111111                               11111111111111111111111111111111111111111111111111111111 
111111111            111111111111                   1                                 111111    111111111111111111111111111111111111111111111111111111111111111111111111111111111111111111111111
111111111   $         111111111111         11111111                                                          11111111111111111111111111111111111111111111111111111111111111111111111111111111111111111111111
111111111            1111111111111                                                                     1111111111111111111111111111111111111111111111111111111111111111111111111111111111111111111111111
111111111            11111111111111   Y       11        11111111111111111111111111111111111111111111111111111111111111111111111111111111111111111111111111
111111111     $       11111111111111        11111111          11111111111111111111111111111111111111111111111111111111111111111111111111111111111111111
111111111               111111111111       11111111        111111111111111111111111111111111111111111111111111111111111111111111111111111111111111111111
111111111     $        111111111111111111111111111        111111111111111111111111111111111111111111111111111111111111111111111111111111111111111111111
111111111                 11111      1111111111111111111     *     111111111111111111111111111111111111111111111111111111111111111111111111111111111111111111111111
111111111           111111111111111111111111111    t   111111111111111111111111111111111111111111111111111111111111111111111111111111111111111111
111111111          1111111111111111111111111111111    11111111111111111111111111111111111111111111111111111111111111111111111111111111111111111
111111111                 111111111111111111111111    11111111111111111111111111111111111111111111111111111111111111111111111111111111111111111
1111111111111111111111                                 111111111111111111111111111111111111111111111111111111111111111111111111111111111111111111111111
111111111111111111111111111111111            111111111111111111111111111111111111111111111111111111111111111111111111111111111111111111111111111111111111111111
11111111111111111111111111111111          $     $      1111111111111111111111111111111111111111111111111111111111111111111111111111111111111111111111111111111111111111111
11111111111111111111111111111111111       $              1111111111111111111111111111111111111111111111111111111111111111111111111111111111111111111111111111111111111111
111111111111111111111111111111111111    $     $         111111111111111111111111111111111111111111111111111111111111111111111111111111111111111111111111111111111111111
111111111111111111111111111111111111111  $      $      111111111111111111111111111111111111111111111111111111111111111111111111111111111111111111111111111111111111111111
111111111111111111111111111111111111111111111111111111111111111111111111111111111111111111111111111111111111111111111111111111111111111111111111111
111111111111111111111111111111111111111111111111111111111111111111111111111111111111111111111111111111111111111111111111111111111111111111111111111