                 11111111111111111111111111111111111111111111111111111
1                     1111111111111111111111111111111111111111111111111111
11                       111111111111111111111111111111111111111111111111111
111              !        111                     11111111111111111111111111111111111111111111111
111111111                                                     11111111111111111111111111111111111111111111
11111111111               111111111111111111111111111111111111111111
111111111111111     Y              11111111111111111111111111111111111111
11111111111111               111111111111111111111111111111111111111
111111111111111111111                 11111111111111111111111111111111
11111111111111111             111111111111111111111111111111111111
11111111111111111111111              111111111111111111111111111111
11111111111111111111111                           111111111111111111111111111111
1111111111111111111111                1111111111111111111111111111111
11111111111111111111111111111111111111111111111111111
11111111111111111111111111111111111111111111111111111
11111111111111111111111111111111111111111111111111111
11111111111111111111111111111111111111111111111111111
11111111111111111111111111111111111111111111111111111
11111111111111111111111111111111111111111111111111111
11111111111111111111111111111111111111111111111111111
11111111111111111111111111111111111111111111111111111
11111111111111111111111111111111111111111111111111111
11111111111111111111111111111111111111111111111111111
11111111111111111111111111111111111111111111111111111