*** ******
*** *** **
***      *
***   ****
*** ** ***
*** ** ***
***      *
***   ** *
*****  *&*
**********